NO assets/eagle.png
SO assets/eagle.png
WE assets/eagle.png
EA assets/eagle.png
C 0,19,73
F 15,6,40

       1111d111
     11110000011011
   1110000000000d111
  1100010000000000011
  1000000000000010001
 110000001000000000011
 100000000000000000001
 100000000000000000001
11000000000000000000011
10000000100000000000001
10000000000000000000001
10000000000W00000001001
10001000000000000000001
10000000000000000000001
11000000000000100000011
 100000000000000000001
 100000000000000000001
 110000000000000100011
  1000000000000000001
  1100000000000000011
   11100001000000111
     11110000011D1
        1111111
