
NO assets/bluestone.png
SO assets/eagle.png
WE assets/eagle.png
EA assets/eagle.png
F 0,100,0
C 240,30,0

11111111111111
10010101000001
10010100000001
11010100000001
100101011D1001
10000000000001
11100S00001001
11111111111111
