NO assets/eagle.png
SO assets/eagle.png
WE assets/eagle.png
EA assets/eagle.png

F 20,20,20
C 200,200,200

111111111111111111111
1S0000000000000000001
111111111111111111111
