NO assets/eagle.png
SO assets/eagle.png
WE assets/eagle.png
EA assets/eagle.png

F 20,20,20
C 200,200,200

111111111111111111111
1000000000000000000S1
111111111111111111111
