NO textures/test/north.xpm
SO textures/test/south.xpm
WE textures/test/west.xpm
EA textures/test/east.xpm

F 20,20,20
C 200,200,200

        1111111111
     1111000001101
   11100000000000111
  1100010000000000011
  1000000000000010001
 110000001000000000011
 100000000000000000001
 100000000000000000001
11000000000000000000011
10000000100000000000001
10000000000000000000001
10000000000S00000001001
10001000000000000000001
10000000000000000000001
11000000000000100000011
 100000000000000000001
 100000000000000000001
 110000000000000100011
  1000000000000000001
  1100000000000000011
   11100001000000111
     1111000001111
        1111111
